####################
#        ##        #
#        ##        #
# P OX ####   OX ###
#        ##        #
# OX     ## OX     #
####################
