###### 
#    ##
# XX  #
# #O O#
#P    #
#######
