  ####
###  #
#P OX##
#   X #
# #O  #
#     #
#######
