######
#    ###
#   OO #
# XXXP #
#  # O #
########
