#################
#                #
#                #
#       PP       #
#       OOO      #
#                #
#                #
#   X   X    X   #
#       P        #
##################
