##################
#                #
#       OOO      #
#       OOO      #
#       OOO      #
#                #
#                #
#   X   X    X   #
#       P        #
##################
