#################
#P               #
#                #
#                #
#       OOO      #
#                #
#                #
#   X   X    X   #
#                #
##################
